111111111111111111111111111111
181600000060000060000060066071
101303330333333333333333377771
101003730370000070000000333331
101033030344444444444446000701
101063030600000000000600007071
161303030344444444444444444441
101703030300000000000400070001
101030030300000404000600000001
101000220220000040000000004001
161022200022000040004004000401
101220007002200000004000040001
106000000000000000600000000001
101700000700000040000400040401
101220000002200000400006740001
101022200022000040000400040401
101000220220006000040400060401
101000000000000440400000400001
101000700060440000000706400401
101000404000000704000000000401
101000400040000000400004000001
101004000004440400000400000401
101004706440004044006000704001
101000000400040040000000007001
101000000000000040000004400001
101111106740006000600700004001
167770100000700000000000000701
166000100004040070404404400001
166000100000000000000000000001
111111111111111111111111111111
