44444444444444444444444444444444444444444444444444
40000000000000000000000000100000000000000000000004
40000011000000000000000001100000000000000000000004
40000001100000000000000001000000000000000000000004
40010000110000000000000011000000000000555555550004
40001000011000000000000010000000005555500000055004
40000100001100000000000010000000555000000000005004
40000110000110000000000010000000550000000000005004
40000011000011000000000010000000005555555550055004
40000111100001100000000110000000000000000000550004
40001100110000110000000100000000000000555555500004
40001000011000011000000100000000000055500000000004
40000000001110001100000100000000000550000000400004
40000000011011000110000100000000000500000000000004
40000000110001100011100100000000000500000440040004
40000011100000110000110100000000000500004000000004
40001110000000011100011100022222222500000000000404
40011000000000010110001100200000002200000000000404
40010000000001100010000000300600000220400040040404
40000000000111000333030033300000000020040000000404
40000000011100000300003330000060000000000000000004
40000000110000000007000000060000060000000040044404
40000001100000000300003330000000000002000000000004
40000011000000000333030033300000600022040000000004
40000110000000000000000000300000002250040040000004
40001100000000000000000000220000022050000000404004
40000000000000000000000000022222220050000000004004
40000000000000000000000000000000000450000000000004
40000000000000000000000000000000000550400440000004
43333333333333333333333333000005555500000000004004
40000000000000000000000000055555000000000000440004
40000000000000000000000005550000004400000000000004
40000333333333333333333355000000000000000000000554
40000300000000000300000550000000000005555555555504
40000300000000000300005000000000555555000000000004
40000300000000000300005000000000000000000000000004
40000300000030000300005550000000000000000000000004
40000330000030000300000055555550000000005555000004
40000030000030000300005550000055555555555000000004
40000030000030000300005000000000000000000000000554
40000030000030000300055000000000000000000055555504
40000030000030000300050000000000000005555550000004
40000030000030000300050000055555555555000000000004
40000030000030000300055500000000000000000000000004
40000030000030000300000550000000000000000000000004
40000030000030000330000005555550000000000555550004
40000030000030000000000000000055555555555500000004
40000000000030000000000000000000000000000000000004
40000000000030000000000000000000000000000000000004
44444444444444444444444444444444444444444444444444
